111111111111
10000C00P0E1
111111111111