111111111111
1E1000000001
110000C00001
100000000101
1C10000001P1
111111111111