111111111111
1E00C0001C01
11C000C00101
1000C00P0001
1C000C000C01
1C000C000C01
100000000001
1C000C000C01
1C000C000C01
100000000001
100000000001
111111111111