11111111111111111111111111111111111111111111111111
1000000000000000000000000000C0000000000000000000C1
1000000000C00000000000000000000000000000P000000001
10000011100001111100000000000011111000011111000001
100000001000000001000001100C0000001000000001000001
100000C0100001111100000000000011111000000001000001
1000000010000000C1000E0110000000001000000001000001
10000000100001111100000000000011111000000001000001
100000C0000000000000C000000000000000000000000000C1
11111111111111111111111111111111111111111111111111