1111111111111111111111111111111111111111111
1E00000000000000000000000000000000000000001
1000000000000000000000000000000000000000001
1000000001111111110000000000001111110000001
1000000110000000000000000000110000001100001
1000001100000000000000000001100000000011001
1000011000000011111110000001000000000001001
100001100000000000110000C001100000000110001
1000001100000000011000000000010000001000001
1000000011111111110000000000001111110000001
1000000000000000000000000000000000000000P01
1111111111111111111111111111111111111111111